1/1/10/60
2/1/15/60
3/1/20/60
4/1/30/60
5/1/45/60
